TILEMAP
650 28							-- Size of tile map in tiles
32 32							-- Tile size & block size
images/SpriteSheetUsado32x32.png 	-- Tilesheet
31 2 								-- Number of tiles in tilesheet
OOOOOOOOOOOOOOOOOOOOOOOOOOOOOOOOOOOOOOOOOOOOOOOOOOOOOOOOOOOOOOOOOOOOOOOOOOOOOOOOOOOOOOOOOOOOOOOOOOOOOOOOOOOOOOOOOOOOOOOOOOOOOOOOOOOOOOOOOOOOOOOOOOOOOOOOOOOOOOOOOOOOOOOOOOOOOOOOOOOOOOOOOOOOOOOOOOOOOOOOOOOOOOOOOOOOOOOOOOOOOOOOOOOOOOOOOOOOOOOOOOOOOOOOOOOOOOOOOOOOOOOOOOOOOOOOOOOOOOOOOOOOOOOOOOOOOOOOOOOOOOOOOOOOOOOOOOOOOOOOOOOOOOOOOOOOOOOOOOOOOOOOOOOOOOOOOOOOOOOOOOOOOOOOOOOOOOOOOOOOOOOOOOOOOOOOOOOOOOOOOOOOOOOOOOOOOOOOOOOOOOOOOOOOOOOOOOOOOOOOOOOOOOOOOOOOOOOOOOOOOOOOOOOOOOOOOOOOOOOOOOOOOOOOOOOOOOOOOOOOOOOOOOOOOOOOOOOOOOOOOOOOOOOOOOOOOOOOOOOOOOOOOOOOOOOOOOOOOOOOOOOOOOOOOOOOOOOOOOOOOOOOOOOOOOOOOOOOOOOOOOOOOOOOOOOOOOOOOOOOOOOOOOOOOOOOOOOOOOOOOOOOOOOOOO
OOOOOOOOOOOOOOOOOOOOOOOOOOOOOOOOOOOOOOOOOOOOOOOOOOOOOOOOOOOOOOOOOOOOOOOOOOOOOOOOOOOOOOOOOOOOOOOOOOOOOOOOOOOOOOOOOOOOOOOOOOOOOOOOOOOOOOOOOOOOOOOOOOOOOOOOOOOOOOOOOOOOOOOOOOOOOOOOOOOOOOOOOOOOOOOOOOOOOOOOOOOOOOOOOOOOOOOOOOOOOOOOOOOOOOOOOOOOOOOOOOOOOOOOOOOOOOOOOOOOOOOOOOOOOOOOOOOOOOOOOOOOOOOOOOOOOOOOOOOOOOOOOOOOOOOOOOOOOOOOOOOOOOOOOOOOOOOOOOOOOOOOOOOOOOOOOOOOOOOOOOOOOOOOOOOOOOOOOOOOOOOOOOOOOOOOOOOOOOOOOOOOOOOOOOOOOOOOOOOOOOOOOOOOOOOOOOOOOOOOOOOOOOOOOOOOOOOOOOOOOOOOOOOOOOOOOOOOOOOOOOOOOOOOOOOOOOOOOOOOOOOOOOOOOOOOOOOOOOOOOOOOOOOOOOOOOOOOOOOOOOOOOOOOOOOOOOOOOOOOOOOOOOOOOOOOOOOOOOOOOOOOOOOOOOOOOOOOOOOOOOOOOOOOOOOOOOOOOOOOOOOOOOOOOOOOOOOOOOOOOOOOOOOOOO
OOOOOOOOOOOOOOOOOOOOOOOOOOOOOOOOOOOOOOOOOOOOOOOOOOOOOOOOOOOOOOOOOOOOOOOOOOOOOOOOOOOOOOOOOOOOOOOOOOOOOOOOOOOOOOOOOOOOOOOOOOOOOOOOOOOOOOOOOOOOOOOOOOOOOOOOOOOOOOOOOOOOOOOOOOOOOOOOOOOOOOOOOOOOOOOOOOOOOOOOOOOOOOOOOOOOOOOOOOOOOOOOOOOOOOOOOOOOOOOOOOOOOOOOOOOOOOOOOOOOOOOOOOOOOOOOOOOOOOOOOOOOOOOOOOOOOOOOOOOOOOOOOOOOOOOOOOOOOOOOOOOOOOOOOOOOOOOOOOOOOOOOOOOOOOOOOOOOOOOOOOOOOOOOOOOOOOOOOOOOOOOOOOOOOOOOOOOOOOOOOOOOOOOOOOOOOOOOOOOOOOOOOOOOOOOOOOOOOOOOOOOOOOOOOOOOOOOOOOOOOOOOOOOOOOOOOOOOOOOOOOOOOOOOOOOOOOOOOOOOOOOOOOOOOOOOOOOOOOOOOOOOOOOOOOOOOOOOOOOOOOOOOOOOOOOOOOOOOOOOOOOOOOOOOOOOOOOOOOOOOOOOOOOOOOOOOOOOOOOOOOOOOOOOOOOOOOOOOOOOOOOOOOOOOOOOOOOOOOOOOOOOOOOOOO
OOOOOOOOOOOOOOOOOOOOOOOOOOOOOOOOOOOOOOOOOOOOOOOOOOOOOOOOOOOOOOOOOOOOOOOOOOOOOOOOOOOOOOOOOOOOOOOOOOOOOOOOOOOOOOOOOOOOOOOOOOOOOOOOOOOOOOOOOOOOOOOOOOOOOOOOOOOOOOOOOOOOOOOOOOOOOOOOOOOOOOOOOOOOOOOOOOOOOOOOOOOOOOOOOOOOOOOOOOOOOOOOOOOOOOOOOOOOOOOOOOOOOOOOOOOOOOOOOOOOOOOOOOOOOOOOOOOOOOOOOOOOOOOOOOOOOOOOOOOOOOOOOOOOOOOOOOOOOOOOOOOOOOOOOOOOOOOOOOOOOOOOOOOOOOOOOOOOOOOOOOOOOOOOOOOOOOOOOOOOOOOOOOOOOOOOOOOOOOOOOOOOOOOOOOOOOOOOOOOOOOOOOOOOOOOOOOOOOOOOOOOOOOOOOOOOOOOOOOOOOOOOOOOOOOOOOOOOOOOOOOOOOOOOOOOOOOOOOOOOOOOOOOOOOOOOOOOOOOOOOOOOOOOOOOOOOOOOOOOOOOOOOOOOOOOOOOOOOOOOOOOOOOOOOOOOOOOOOOOOOOOOOOOOOOOOOOOOOOOOOOOOOOOOOOOOOOOOOOOOOOOOOOOOOOOOOOOOOOOOOOOOOOOOOO
                                                                                                            b444444444444444444444444444444                                2222222JJJJJJJJJJJJJJJJJJJJJJJJJJJJJJJJJJJJJJJJJJJJJJJJJJJJJJJJJJJJJJJJJJJJJJJJJJJJJJJJJJJJJJJJJJJJJJJJJJJJJJJJJJJJJJJJJJJJJJJJJJJJJJJJJJJJJJJJJJJJJJJJJJJJJJJJJJJJJJJJJJJJJJJJJJJJJJJJJJJJJJJJJJJJJJJJJJJJJJJJJJJJJJJJJJJJJJJJJJJJJJJJJJJJJJJJJJJJJJJJJJJJJJJJJJJJJJJJJJJJJJJJJJJJJJJJJJJJJJJJJJJJJJJJJJJJJJJJJJJJJJJJJJJJJJJJJJJJJJJJJJJJJJJJJJJJJJJJJJJJJ;;;;;;;;;2       RRRTTTTTTTTTTTTTTTTTTTTTTTTTTTTTTTTTTTTTTTTTTTTTTTTTTTTTTTTTTTTTTTTTTTTTTTUGGGGGGGGGGGGGGGGGGGGGGGGGGGGGGGGGGGGGHH
                                                                                                            b444444444444444444444444444444                                 2222222QQ5QQQQQQQQQQQQQQQQQQQQQQQQQ5QQQQQQQQQQQ5QQQQQQQQQQQQQQQQQQQQQQQQQQQQQQ5QQQQQQQQQQQQQQQQQQQQQQQQQQQQQQPJJJJJJJJJJJPJJJJJJJJJJJJJJJJJPJJJJJJJJJJJPQQQ5QQQQQQQ5QQQQQQQQQ5QQQQQQQQQQQQQ5QQQ5QQQQQQQPPPPPPQQQ5QQQQQQQQQ5PPPPPPQQQQQQ5QQQ5QQQQQQQQ5QQQQQQQ5QQQQQQQQQ5QQQQQQQQQQQQQQQQQQQQQQQQQQQQ5QQQQQQQQQQQPJJJJJJJJJJJJJJJJJJJJJJPJJJJJJJPQ5QQQQQQQQQQQQQQQQ222         RRR^^^^^^^^^^^^^^^^^^^^^^^^TTTTTTTTTTTTTTTTTTTTTTTTTTTTTTTTTTTTTTTTTTTTTT^EEEEEEEEEEEEEEEEEEEEEEEEEEEEEEEEEEEEEE>
                                                                                                            b444444444444444444444444444444                                  2222222QQQQ5QQQQQ5QQQQQQQQQQQQQQQQQQQQQ5QQQQQQQQQQQQQ5QQQQQ5QQQQQQQQQQQQQQQQQQQQQQQQQ5QQQQQQQQQQQQ5QQQQQQQQQ:JJJJJJJJJJJPJJJJJJJJJJJJJJJJJPJJJJJJJJJJJPQQQQQQQQQQQQQQQ5QQQQQQQ5QQQQQQQQQQQQQQQQQQQQ5QQPPPPPPQQQQQQQ5QQQQQQPPPPPPQQQQQQQQQQQQQQQ5QQQQQQQQQQQQQQQ5QQQQQQQQQQ5QQQQQQQQQQQQQQQQQQQQQQQQQQQQQQQ5QQQPJJJJJJJJJJJJJJJJJJJJJJPJJJJJJJPQQQQQQQQQ5QQQQQQQQ222         RRR^^^^^^^^^^^^^^^^^^^^^^^^^^^^TTTTTTTTTTTTTTTTTTTTTTTTTTTTTTTTTTTTTTTTT^EEEEFEEEEEEEEEEFEEEEEEEEEEEEEEEEEEFEEEE>
                                                                                                            eaaaaaaaaa4444444444444444444af                                   2222222QQQQQQQQQQQQQQQQ5QQQQQQQ6QQQQQQQQQQ6QQQQQQQQQQQQQQQQQQQQQQ5QQQQQQQQQQQQQQQQ5QQQQQ5QQQQQQQ6QQQQQQ5QQQQQQQQQQ5QQQQPJJJJJJJJJJJJJJJJJPJJJJJJJJJJJPQQQQQQQQ5QQQQQQQQQQQQQQQQQQQ5QQQQ5QQQQQQQQQQQQQPPPPPP5QQQQQQQQQ6QQQPPPPPPQQQQ5QQQQQQQ6QQQQQQQQQQQ5QQQQQQQQQ6QQQQQQQQQQQQQQQQQQQQ5QQQQQQQQQQQQQQQQ5QQQQQPJJJJJJJJJJJJJJJJJJJJJJPJJJJJJJPQQQQQQQ5QQQQQ5QQQQ222         RRR^^^^=^^^^^^^^^^^^^^^^^^^=^^^^^TTTTTTTTTTTTTTTTTTTTTTTTTTTTTTTTTTTTT^^EEEEEEEEEEEEEEEEEEEEEEEEEEEEEEEEEEEEEEEE>
                                                                                                                      eaa444444444aaaaaaf                                      2222222QQQQQQ6QQQQQQQQQQQQQQQQQQQQQQQQQQQQQQQQQQQQQQQQQ5QQQQQQQQQQQQQQQQQ5QQQQQQQQQQQQQQQQQ5QQQQQQQQQQQQQQQQQQQQQQQQQQPJJJJJJJJJJJJJJJJJPJJJJJJJJJJJPQQQQQQQQQQQQQQQQQQQQQQQQQQQQQQQQQQQQQQQQQQQQQQQPPPPPPQQQQQQQQQQQQQQPPPPPPQQQQQQQQQQQQQQQQQQQQQQQQQQQQQQQQQQQQQQQQQQQQQQ5QQQQQQQQQQQQQQQQQ5QQQQQ6QQQQQQQ:JJJJJJJJJJJJJJJJJJJJJJPJJJJJJJPQQQQQQQQQQQQQQQQQ222            RR^^^^^^^^^^^^^^^^^^^^^^^^^^^^^^^^^^^^^^^=^TTTTTTTTTTTTTTTTTTTTTTTT^^^EEEEEEEEEEEEEEEEEEEEEEEEEEEEEEEEEEEEEEEE>
                                                                                                                         eaaaaaaaf                                              222222QQQQQQQQQQ5QQQQQQQQQ5QQQ5QQQQQQQ5QQQQQQQ56QQQQQQQQQQQQQQQQQQQQQQQQQQQQQQQQQQQQQQQQQQQQQQQQQQQQQQQQQQQQQQQQQQQQQPJJJJJJJJJJJJJJJJJPJJJJJJJJJJJPQQ5QQQQQQQQQQQQQQQQQ6QQQQQQQQQQQQQQQQQ5QQQQ5QQQ::::::QQQQQQQQQQQQQQ::::::QQQQQQQQQ5QQQQ5QQQ5QQQQQQQQQQQQQQQQQQQ5QQQQQQQQQQQQQQQQQQQQQQQQQQQQQQQQQQQQQQQQQQQQ5QQQQ6QQQQQQQQQQQQPJJJJJJJPQQQQQQQQQQQQQQQQQ222             RR^^^^^^^^^^^^^^^^^^^^^^^^^^^^^^^^^^^^^^^^^^^^^TTTTTTTTTTTTTTTT^^^^^EEEEEEEEEEEEEEEEEEEEEEEEEEFEEEEEEEEEEEEEE>
                                                                                                                                                                                 222222QQQQQQQQQQQQQQQQQQQQQQQQQQQQQQQQQQQ5QQQQQQQQQQQQQQQQQQ5QQQQQ5QQQ6QQQQQQQQQQQQQQQQQQQQQQQQQQQQ5QQQQQQQ5QQ5QQQQ5QQQQQQQQQQQQQQQQQQPJJJJJJJJJJJPQQQQQQQQQQQQQQQQ5QQQQQQQQQQQQQQQQQQ5QQQQQQQQQQQQQQQQQQQQQQQQQ5QQQQQQQQQQQQQQQQQ5QQQQQQQQQQQQQQQQQQQQQQQQQ5QQQQQQQQQQQQQQQQQQQQ5QQQQQ5QQQQQQQQQQQQQQQQQQQQQQQQQQQQQQQQQQQQQQ5QQPJJJJJJJPQQQQQQQQQQQQQQQQQ222             RR^^^^^^^^^^^^^^^=^^^^^^^^^^^^^^^^^^^^^^^^^^^^^^^^^^^^^^^^^^^^^^^^^^EEEEEEEEEEEEEEEEEEFEEEEEEEEEEEEEEEEEEEEEE>
                                                                                                                                                                                      QQQQQ5QQQQQQQQQ5QQQQQQQQQQQQQQQQQQQQQQQQQQQQQQQQQQQQQQQQQQQQQQQQQQQQQQQQQQQQQQQQ5QQQ5QQQQ5QQQQQQQ5QQQQQQQQQQQQQQQQQ5QQQQQQQQQQQQQPJJJJJJJJJJJ:QQQQQQ5QQQ5QQQQQQQQQQQQQQQQQQQQQQQQQQQQQQQQQQQQQQQQ5QQQ5QQQQQQQQQQQQQQQQQQQQQQQQQQQQQQQQQQQQQQQ5QQQ5QQQQQQQQQQQQQQQQQQQQQQQQQQQQQQQQQQQQQQQQQQQQQQQQQQQ5QQQ5QQQQQQQQQQQQQQQQQQPJJJJJJJPQQQQQQQQQQQQQ5QQQ222             RR^^^^^^^^^^^^^^^^^^^^^^^^^^^^^^^^^^^^^^^^^^^^^^^^^^^^^^^^^^^^^^^^^EEEEEEEEEEEEEEEEEEEEEEEEEEEEEEEEEEEEEEEEEE>
                                                                                                                                                                                      QQQQQQQQQQQQQQQQQQQQQQQQ5QQQQQ5QQQQQQQQQQQQQQQQ5QQQQQQQQQQQQQQQQQQQQQQ5QQ5QQQQQQQQQQQQQQQQQQQQQQQQQQQQQ5QQQQQQQQQQQQQQQQQQQQQQQQQ:QQQQQQQQQQQQQQQQQ6QQQQQQQQQQQQQQQQQQQQQQQQQQ5QQQQQQQQQQQQQQQQQQQQQQQQQQQQQQQQQQQQQQQQQQQ5QQQQQQQQQQQQQQQQQQQQ6QQQQQQQQQQQQQQQQQQQQQQQQQQQQQQQ6QQQQQQQQQQQ5QQ5QQQQQQQQQQQQQQQQQQ5QQQQQQQQQQPJJJJJJJPQQQ5QQ5QQQQQQQQQ222              RR^^^^^^^^^^^^^^^^^^^^^^^^^^^^^^^^^^^^^^^^^^^^^^^^^^^^^^^^^^^^^^^^^EEEEEEEEEEEEEFEEEEEEEEEEEEEEEEEEEEEEEEEEEE>
                                                                                                                                                                                      QQQQQQQQ5QQQQQQQQQQQQQQQQQQQQQQQQQQQQQQ5QQ6QQQQQQQQQQQQQQQQQQQQQQQQQQQQQQQQQQQQQQQQQQQQQQQQQQQQQQQQQQQQQQQQ5QQQQQQQQQQQQQQQ5QQQQQQQQQQQ5QQQQQQQ5QQQQQQQQQQQQQQQQQQQQQQQQ5QQQQQQQQQQQ5QQQQQQQ5QQQQQQQQQQQQQQQQQQQQQQQ5QQQQQQQQQQQ5QQQQQQQ5QQQQQQQQQQQQQQQQQQQQQQQQQQQQQQQQQQQQQQQQQQQQQQQQQQQQQQQQQQQQQQQQQQQQQQQQQQQQQQQQQQQ:JJJJJJJ;QQQQQQQQQQQQQQQQ222              RR^^^^^^^^^^^^^^^^^^^^^^^^^^^^^^^^^^^^^^^^^^^^^^^^^^=^^^^^^^^^^^^^^EEEEEEEEEEEEEEEEEEEEEEEEEEEEEEEEEEEEEEEEEE>
                                                                                                                                                                                      QQQQQQQQQQQQQQQQ5QQQQQQQQQQQQQQQQQQQQQQQQQQQQQQQQQQQQQQQQ5QQQ5QQQQQQQQQQQQQQQQQQQQQQQQQQQQQQQ5QQQQQQQQQQQQ6QQQQQQ5QQQQQQQQQQQQQQQQQQQQQQQQQQQQQQQQQQQQQ5QQ5QQQQQQQQQQQQQQQQQQQQQQQQQQQQQQQQQQQQQQQQQ5QQ5QQQQQQQQQQQQQQQQQQQQQQQQQQQQQQQQQQQQQQQQ5QQ5QQQQQQQQQQQQQQQQQQQQQQQQQQ5QQQ5QQQQQQQQQQQQQQQQQQQQQQQQQQQQQQQQ6QQQQQQQ5QQQ5QQQQQQQQQQ6QQQQQQQQQQ222              RR^^^^^^^^^^^^^^^^^^^^^^^^^^^^^^^^^^^^^^^^^^^^^^^^^^^^^^^^^^^^^^^^^EEEEEEEEEEEEEEEEEEEEEEEEEEEEEEEEEEFEEEEEEE>
                                                                                                                                                                                      QQQQQQQQQQQ5QQQQQQQQQQQQQQQQ5QQQQQQQQQQQQQQQQQQQQQQ5QQQQQQQQQQQQQQQQQQQQQQQQQ5QQQQQQ5QQQQQQQQQQQQ5Q5QQQQQQQQQQ5QQQQQQQQQQQQQQQQQ5QQQQQQQQQQ5QQQQQQ5QQQQQQQQQQQQQQQQQQQQQQQQQQ5QQQQQQQQQQ5QQQQQQ5QQQQQQQQQQQQQQQQQQQQQQQQQ5QQQQQQQQQQ5QQQQQQ5QQQQQQQQQQQQQQQQQQQQQQQQQQQQ5QQQQQQQQQQQQQQQQQQQQQQQQQ5QQQQQQ5QQQQQQQQQQQ5QQQQQQQQQQQQQQQQQQQQQQQQQ5QQQQQ222              RR^^^^^^^^^^^^^^^^^^^^^^^^^^^^^^^^^^^^^^^^^^^^^^^^^^^^^^^^^^^^^^^^^EEEEEEEEEEEEEEEEEEEEEEEEEFEEEEEEEEEEEEEEEE>
                                                                                                                                                           dc                         QQQQQQQQQQQQQQQQQQQQQQQQQQQQQQQQ5QQQQQQQQQQQQQQQQQQQQQQQQQQQQQQQQQQQQQ5QQQQQQQQQQQQQQQQQQQQQQQQQQQQQQQQ5QQQQQQQQQQQQQQQQQQQQQQQQQQQQQQQQQQQQQQQQQQQQQQQQQQQQQ5QQQQ5QQQQQQQQQQQQQ6QQQQQQQQQQQQQQQQQQQQQQQQQ5QQQQ5QQQQQQQQQQQQQQQQQQQQQQQQQQQQQQQQQQQQQQ5QQQQ5QQQQQQQQQQQQQQQQQQQQQQQQQQQQQQQ5QQQQQQQQ1JJJJJJJJJJJJJJJ1QQQQQQQQQQQQQQQQQQQ5QQQQQQQQQQQQ222              RR^^^^^^^^=^^^^^^^^^^^^^^^^^^^^=^^^^^^^^^^^=^^^^^^^^^^^^^^^^^TTT^^^EEEEEEEFEEEEEEEEEEEEEEEEEEEEEEEEEEEEEEEEEE>
                         d8888888888c                                                                                                                     d44c                   222222QQQQQ5QQQQQQQQ6QQ5QQQQQ5QQQQQQQQQQ5QQQQQQQQQ5QQQ55QQQQQQQQQQQQQQQQQQQQQQQQQQQQQQQQQQQQQ5QQQQQ5QQQQQQQQQQQQQQQQQQQQ6QQQQQQQQQQQQQQQQQQQQQ5QQQQQQQQQQQQQQQQQQQQQQQQQQQQQQQQQQQQQQQQQQQQ5QQQQQQQQQQQQQQQQQQQQQQQQQQQQQQQQQQQQQQQQQQQ5QQQQQQ6QQQQQQQQQQ6QQQQQQQQQQQQQ5QQQ55QQQQQQQQQQQQQQQQQQQQQQQQQQQQPJJJJJJJJJJJJJJJPQQQQQQQQQQQQQQQQQQQQQQQQQQQQQQQQQ222             RR^^^^^^^^^^^^^^^^^^^^^^^^^^^^^^^^^^^^^^^^^^^^^^^^^^^^^^^^^^TTTT^^^^EEEEEEEEEEEEEEEEEEFEEEEEEEEEEEEEEEEEEEEEE>
                         b44444444444                                                                                                                     b444                  222222QQQQ5QQQQQQQQ5QQQQQQQQQQQQQQQQPJJJJJJJPJJJJJJJPJJJJJJJPJJJJJJJPQQ5QQQQQQQQQQQQQQQQQQQQQQQQQQQQQQQQ5QQQQQQQQQQQQQQQQQQ5QQQQQQ5QQQ55QQQ5QQQQQQQQQQQQQ5QQQQQQQQQQQQQQQQQQQQQ5QQQ55QQQ5QQQQQQQQQQ111111QQQQQQQ6QQQQQQ111111QQ55QQQQQQQQQQQQQQQQQ5QQQQQQQQQQQQQQQQQQQQQQQQQQQQQQQQQQQQQQQQQ5QQQQQQQQQ6QQQPJJJJJJJJJJJJJJJPQQQQQQQQQQQQQQ5QQQQQQQQQQQQQQQQQQ222             RR^^^^^^^^^^^^^^^^^^^^^^^^^^^^TTTTTTT^^^^^^^^^^^^^^^^^^^^^^^TTTTT^^^EEEEEEEEEEEEEEEEEEEEEEEEEEEEEEEEEEEEEEEEE>
                         b44444444444c                                                                                                                   d4444c                2222222QQQQQQQQQQQQQQQQQQQQQQQQQQQQQQPJJJJJJJPJJJJJJJPJJJJJJJPJJJJJJJPQQQQQQQQQQQQQQQQQQQQQQQQQQQQQQQQQ6QQQQQQ5QQQQQQ5QQQQQQQQQQQQQQQQQQQQQQQQQQQQQQ5QQQQQQQQQQQQQQQQQQQQQQQQQQQQQQQQQQQQQQQQQQQQ5QQPPPPPPQQQQQQQQQQQQQQPPPPPPQQQQQQQQQQQQQQQ5QQQQQQQQQQQQQQQQQQQQQQQ5QQQQQQQQQQQQQQQQQ5QQQQQQ1JJJJJJJJJJJJPJJJJJJJJJJJJJJJPQQQQQQQQ5QQ6QQQQQQQQQQQQQQQQQQQQQ222             RR^^^^^^^^^^^^^^^^^^^^^^^^^^TTTTTTTTTTTTT^^^^^^^^^^^^^^^^^^TTTTTT^^^^EEEEEEEEEEEEEEEEEEEEEEEFEEEEEEEEEEEEEEEE>
                        d444444444444488888888888888888888888888888888888888888888888c                                                                  d444444c              2222222QQQQQQQQQQQQQQQQQQQQQQQQQQQQQQQPJJJJJJJPJJJJJJJPJJJJJJJPJJJJJJJPQQQQQQQQQQQQQQQQQQQQQQQQQQQQQ5QQQQQQQQQQQQQQ5QQQQQQQQQQQQQQQQQQQQQQQQQQQQQQQQQQQQQQQQQQQQQQ5QQQQQQQQQQ5QQQQQQQQQQQQQQQQQQQQQQQPPPPPPQQQQ5QQQQQQQQQPPPPPPQQQQQQQQQQQQQQQQQQQQQQQQQQQQ5QQQQQQQQQQQQQQQQQQQQQQQQQQQQQQQQQQQPJJJJJJJJJJJJPJJJJJJJJJJJJJJJPQQQQQQQQQQQQQQQQQQQQQQQQQQQQQQQQQQ222           RR^^^^^^^^^^^^^^^^^^=^TTTTTTTTTTTTTTTTTTTTTTTTT^^^^^^^^^^^^TTTTTTTT=^^EEEEEEEEEFEEEEEEEEEEEEEEEEEEEEEFEEEEEEEE>
888888888888888888888888444444444444444444444444444444444444444444444444444444444444448c                                                               d44444444c            2222222QQ5QQQ6QQQQ5QQQQQQQQQ5QQQQ5QQQQQPJJJJJJJPJJJJJJJPJJJJJJJPJJJJJJJPQQQQQQ6QQQQ5QQQQQ5QQQQQQQQQQQQQQQQQQQ5QQQQQQQQQQQQQQ5QQQQQQQQQQQQQQQQ6QQQQQQQQQQQQQQQQQQQQQQQQQQQQQQ5QQQQQQQQQQQQQQQQQQQQQQQQQPPPPPPQQQQQQQQQQQQQ5PPPPPPQQQQQ6QQQQQQQQQQQQQQQQQQQQQQQQQQQQQQQ5QQQQQQQ6QQQQQQQQQQQQQQQQQQPJJJJJJJJJJJJPJJJJJJJJJJJJJJJPQQQQQQQQQQQQQQQQQQQQQQQ5QQQQQ5QQQQ222          RRR=^^^^^^^^^^^TTTTTTTTTTTTTTTTTTTTTTTTTTTTTTTTTTTT^^^^TTTTTTTTTTTTTT^^^EEEEEEEEEEEEEEEEEEEEEEEEEEEEEEEEEEEEEEE>
4444444444444444444444444444444444444444444444444444444444444444444444444444444444444444c                                                             d4444444444c          2222222QQQQQQQQQQQQQQQQQQQ5QQQQQQQQQQQ6QPJJJJJJJPJJJJJJJPJJJJJJJPJJJJJJJPQQQQQQQQQQQQQQQQQQQQQQ5QQQQQQQQ5QQQQQQQQQQQQQQQQQQQQQQQQQQQQQQQQ5QQQQQQQQ5QQQQQQ5QQQQQQ5QQQQQQQQQQQQQQQQQQQQQ5QQQQQQQQQQQQQQQ5PPPPPP5QQQQQQQQQQQQQPPPPPPQ5QQQQQQQQ5QQQQQQ5QQQQQQ5QQQQQQQQQQQQQQQQQQQQQQQQQ5QQQQQQQQQQQQQPJJJJJJJJJJJJPJJJJJJJJJJJJJJJPQ5QQQQQQQQQQQQQQQQQQQQQQQQQQQQQQQQ2222         RR^^^^^^^^^^^TTTTTTTTTTTTTTTTTTTTTTTTTTTTTTTTTTTTTTTTTTTTTTTTTTTTTTTTTT^^EEEEEEEEEEEEEEEEEEEEEEEEEEEEEEEEEEEEEF>
44444444444444444444444444444444444444444444444444444444444444444444444444444444444444444                                                            d444444444444c        2222222JJJJJJJJJJJJJJJJJJJJJJJJJJJJJJJJJJJJJJJJJJJJJJJJJJJJJJJJJJJJJJJJJJJJJJJJJJJJJJJJJJJJJJJJJJJJJJJJJJJJJJJJJJJJJJJJJJJJJJJJJJJJJJJJJJJJJJJJJJJJJJJJJJJJJJJJJJJJJJJJJJJJJJJJJJJJJJJJJJJJJJJJJJJJJJJJJJJJJJJJJJJJJJJJJJJJJJJJJJJJJJJJJJJJJJJJJJJJJJJJJJJJJJJJJJJJJJJJJJJJJJJJJJJJJJJJJJJJJJJJJJJJJJJJJJJJJJJJJJJJJJJJJJJJJJJJJJJJJJJJJJJJJJJJJJJJJJJJJJJJJ;;;;;;;;;2       RRRTTTTTTTTTTTTTTTTTTTTTTTTTTTTTTTTTTTTTTTTTTTTTTTTTTTTTTTTTTTTTTTTTTTTTTTULLLLLLLLLLLLLLLLLLLLLLLLLLLLLLLLLLLLLMM
OOOOOOOOOOOOOOOOOOOOOOOOOOOOOOOOOOOOOOOOOOOOOOOOOOOOOOOOOOOOOOOOOOOOOOOOOOOOOOOOOOOOOOOOOOOOOOOOOOOOOOOOOOOOOOOOOOOOOOOOOOOOOOOOOOOOOOOOOOOOOOOOOOOOOOOOOOOOOOOOOOOOOOOOOOOOOOOOOOOOOOOOOOOOOOOOOOOOOOOOOOOOOOOOOOOOOOOOOOOOOOOOOOOOOOOOOOOOOOOOOOOOOOOOOOOOOOOOOOOOOOOOOOOOOOOOOOOOOOOOOOOOOOOOOOOOOOOOOOOOOOOOOOOOOOOOOOOOOOOOOOOOOOOOOOOOOOOOOOOOOOOOOOOOOOOOOOOOOOOOOOOOOOOOOOOOOOOOOOOOOOOOOOOOOOOOOOOOOOOOOOOOOOOOOOOOOOOOOOOOOOOOOOOOOOOOOOOOOOOOOOOOOOOOOOOOOOOOOOOOOOOOOOOOOOOOOOOOOOOOOOOOOOOOOOOOOOOOOOOOOOOOOOOOOOOOOOOOOOOOOOOOOOOOOOOOOOOOOOOOOOOOOOOOOOOOOOOOOOOOOOOOOOOOOOOOOOOOOOOOOOOOOOOOOOOOOOOOOOOOOOOOOOOOOOOOOOOOOOOOOOOOOOOOOOOOOOOOOOOOOOOOOOOOOO
OOOOOOOOOOOOOOOOOOOOOOOOOOOOOOOOOOOOOOOOOOOOOOOOOOOOOOOOOOOOOOOOOOOOOOOOOOOOOOOOOOOOOOOOOOOOOOOOOOOOOOOOOOOOOOOOOOOOOOOOOOOOOOOOOOOOOOOOOOOOOOOOOOOOOOOOOOOOOOOOOOOOOOOOOOOOOOOOOOOOOOOOOOOOOOOOOOOOOOOOOOOOOOOOOOOOOOOOOOOOOOOOOOOOOOOOOOOOOOOOOOOOOOOOOOOOOOOOOOOOOOOOOOOOOOOOOOOOOOOOOOOOOOOOOOOOOOOOOOOOOOOOOOOOOOOOOOOOOOOOOOOOOOOOOOOOOOOOOOOOOOOOOOOOOOOOOOOOOOOOOOOOOOOOOOOOOOOOOOOOOOOOOOOOOOOOOOOOOOOOOOOOOOOOOOOOOOOOOOOOOOOOOOOOOOOOOOOOOOOOOOOOOOOOOOOOOOOOOOOOOOOOOOOOOOOOOOOOOOOOOOOOOOOOOOOOOOOOOOOOOOOOOOOOOOOOOOOOOOOOOOOOOOOOOOOOOOOOOOOOOOOOOOOOOOOOOOOOOOOOOOOOOOOOOOOOOOOOOOOOOOOOOOOOOOOOOOOOOOOOOOOOOOOOOOOOOOOOOOOOOOOOOOOOOOOOOOOOOOOOOOOOOOOOOO
OOOOOOOOOOOOOOOOOOOOOOOOOOOOOOOOOOOOOOOOOOOOOOOOOOOOOOOOOOOOOOOOOOOOOOOOOOOOOOOOOOOOOOOOOOOOOOOOOOOOOOOOOOOOOOOOOOOOOOOOOOOOOOOOOOOOOOOOOOOOOOOOOOOOOOOOOOOOOOOOOOOOOOOOOOOOOOOOOOOOOOOOOOOOOOOOOOOOOOOOOOOOOOOOOOOOOOOOOOOOOOOOOOOOOOOOOOOOOOOOOOOOOOOOOOOOOOOOOOOOOOOOOOOOOOOOOOOOOOOOOOOOOOOOOOOOOOOOOOOOOOOOOOOOOOOOOOOOOOOOOOOOOOOOOOOOOOOOOOOOOOOOOOOOOOOOOOOOOOOOOOOOOOOOOOOOOOOOOOOOOOOOOOOOOOOOOOOOOOOOOOOOOOOOOOOOOOOOOOOOOOOOOOOOOOOOOOOOOOOOOOOOOOOOOOOOOOOOOOOOOOOOOOOOOOOOOOOOOOOOOOOOOOOOOOOOOOOOOOOOOOOOOOOOOOOOOOOOOOOOOOOOOOOOOOOOOOOOOOOOOOOOOOOOOOOOOOOOOOOOOOOOOOOOOOOOOOOOOOOOOOOOOOOOOOOOOOOOOOOOOOOOOOOOOOOOOOOOOOOOOOOOOOOOOOOOOOOOOOOOOOOOOOOOOO
OOOOOOOOOOOOOOOOOOOOOOOOOOOOOOOOOOOOOOOOOOOOOOOOOOOOOOOOOOOOOOOOOOOOOOOOOOOOOOOOOOOOOOOOOOOOOOOOOOOOOOOOOOOOOOOOOOOOOOOOOOOOOOOOOOOOOOOOOOOOOOOOOOOOOOOOOOOOOOOOOOOOOOOOOOOOOOOOOOOOOOOOOOOOOOOOOOOOOOOOOOOOOOOOOOOOOOOOOOOOOOOOOOOOOOOOOOOOOOOOOOOOOOOOOOOOOOOOOOOOOOOOOOOOOOOOOOOOOOOOOOOOOOOOOOOOOOOOOOOOOOOOOOOOOOOOOOOOOOOOOOOOOOOOOOOOOOOOOOOOOOOOOOOOOOOOOOOOOOOOOOOOOOOOOOOOOOOOOOOOOOOOOOOOOOOOOOOOOOOOOOOOOOOOOOOOOOOOOOOOOOOOOOOOOOOOOOOOOOOOOOOOOOOOOOOOOOOOOOOOOOOOOOOOOOOOOOOOOOOOOOOOOOOOOOOOOOOOOOOOOOOOOOOOOOOOOOOOOOOOOOOOOOOOOOOOOOOOOOOOOOOOOOOOOOOOOOOOOOOOOOOOOOOOOOOOOOOOOOOOOOOOOOOOOOOOOOOOOOOOOOOOOOOOOOOOOOOOOOOOOOOOOOOOOOOOOOOOOOOOOOOOOOOOOO
